8 10
..#.......
......#.F.
...#######
..........
#######.##
.....#....
.S.#.#....
...#......